L4D2: The Concert
An Interactive Fiction by Victor Nguyen
Release 1 / Serial number 110827 / Inform 7 build 6G60 (I6/v6.32 lib 6/12N) SD

Safe Room
The Safe Room looks like it used to be a storage room. 
There's graffiti scrawled all over the walls.
EAST:The Hallway.

Coach: "Alright, heres the plan. Y'all know the Midnight Riders? They're gonna save us."

 Ellis: "I hate to break it to ya Coach, but I don't think they're actually here."

 Coach: "We'll set off their finale and the chopper gotta know something's up. And nobody, and I mean NOBODY has the bigger light show than the Midnight Riders."

 Rochelle:"...And that will signal the chopper! Coach, that's brilliant! ...I'm sorry about all the bad things I said about your crappy band..."

 (Starring you as Nick): "Coach, that is the stupidest idea I've ever agreed with."

 Coach: "Alright then, everybody grab a weapon and let's move!"

You can see Rochelle, Coach and Ellis here.

>look
Safe Room
The Safe Room looks like it used to be a storage room. 
There's graffiti scrawled all over the walls.
EAST:The Hallway.

You can see Rochelle, Coach and Ellis here.

>take medpack
Taken.

The Bob grows larger and larger, gathering its power.

The Big Daddy lunges towards the Bob.

The Bob strikes up a defensive pose.

The Big Daddy misses the Bob.

Act

>showme medpack
medpack - medpack
location: in stage there out of play
singular-named, improper-named; unlit, inedible, portable, neuter, ordinarily enumerated
printed name: "medpack"
printed plural name: "medpacks"
indefinite article: none
description: none
initial appearance: none

The nightmare grows larger and larger, gathering its power.

Act

* * *

>take medpack
Taken.

The Bob grows larger and larger, gathering its power.

The Big Daddy lunges towards the Bob.

The Bob strikes up a defensive pose.

The Big Daddy misses the Bob.

Act

>look
Stage
You can see a Bob and a Big Daddy here.

Act

>heal
I'm healing! Cover me!

The Big Daddy concentrates, and is now mildly concentrated.

The Bob pulls back and begins roiling and seething, building its strength.

Act

>concentrate
You concentrate, and are now mildly concentrated.

The Big Daddy lunges towards the Bob.

The Bob grows larger and larger, gathering its power.

The Big Daddy hits the Bob. The Bob loses concentration!

The Bob pulls back and begins roiling and seething, building its strength.

Act

>attack Bob
The Bob strikes up a defensive pose.

You hit the Bob. The Bob loses concentration!

The Big Daddy concentrates, and is now mildly concentrated.

The Bob readies the Bob's natural weapon.

Act

* * *

>take medpack
Taken.

The Bob grows larger and larger, gathering its power.

The Big Daddy lunges towards the Bob.

The Bob strikes up a defensive pose.

The Big Daddy misses the Bob.

Act

>concentrate
You concentrate, and are now mildly concentrated.

The Bob grows larger and larger, gathering its power.

The Big Daddy lunges towards the Bob.

The Bob strikes up a defensive pose.

The Big Daddy misses the Bob.

Act

>concentrate
You concentrate, and are now quite concentrated.

The Bob grows larger and larger, gathering its power.

The Big Daddy lunges towards the Bob.

The Bob strikes up a defensive pose.

The Big Daddy misses the Bob.

The Bob grows larger and larger, gathering its power.

Act

>concentrate
You concentrate, and are now maximally concentrated.

The Big Daddy lunges towards the Bob.

The Bob strikes up a defensive pose.

The Big Daddy misses the Bob.

Dark tentacles whip mercilessly towards you.

React

>attack
(the Bob)
Attacking is an action, not a reaction.

React

>dodge
You get ready for quick evasive maneuvers.

You twist desperately aside as the horrible thing just misses you!

Act

>attack
(the Bob)
The Bob pulls back and begins roiling and seething, building its strength.

You miss the Bob.

The Big Daddy lunges towards the Bob.

The Bob grows larger and larger, gathering its power.

The Big Daddy misses the Bob.

The Bob grows larger and larger, gathering its power.

Act

* * *

>look
Safe Room
The Safe Room looks like it used to be a storage room. 
There's graffiti scrawled all over the walls.
EAST:The Hallway.

You can see Rochelle, Coach and Ellis here.

>attack infecteds
You make a mad dash at the Ellis and prepare to swing your katana. 
 This Infected got hit by aoe.
 This Infected got hit by aoe.
 This Infected got hit by aoe.
 This Infected got hit by aoe.

You managed to deal the finishing blow to the dead infected!
The common infected dies

Coach yells at the infected and prepares to swing his katana. 
The infected gets ready for quick evasive maneuvers.

 This Infected got hit by aoe.

Coach lands the finishing blow on the dead infected!
The common infected dies

The infected lunges towards Coach.

The infected misses Coach.

The infected lunges towards Ellis.

The infected misses Ellis.

Rochelle screams at the Tank and prepares to swing her katana. 
 This Infected got hit by aoe.
 This Infected got hit by aoe.
 This Infected got hit by aoe.
 This Infected got hit by aoe.

Rochelle lands a few hits on the Tank and it growls furiously! 

The tank throws the concrete at Ellis. 
Ellis is hit by the rock.

Ellis groans trying to stand up.

Act

>attack infecteds
You can't see any such thing.

Act

>look
Stage
You can see a Tank, Rochelle, Coach, Ellis, a gnome, a cola and a med kit here.

Act

* * *

>look
Safe Room
The Safe Room looks like it used to be a storage room. 
There's graffiti scrawled all over the walls.
EAST:The Hallway.

You can see Rochelle, Coach and Ellis here.

>attack infected
You make a mad dash at the Ellis and prepare to swing your katanafire. 
 This Infected got hit by aoe.

You managed to deal the finishing blow to an dead infected!

You kill the infected.

Coach yells at the Tank and prepares to swing his katana. 
 This Infected got hit by aoe.

Coach lands a few hits on the Tank and it growls furiously! 

Rochelle lunges at the Tank and prepares to swing her katana. 
Rochelle lands a few hits on the Tank and it snarls furiously! 

The Tank grabs a giant chunk of rock from the ground. 
Act

>look
Stage
You can see a Tank, Rochelle, Coach, Ellis, a gnome, a cola and a med kit here.

Act

>attack infected
Attacking is an action, not a reaction.

React

>look
Stage
You can see a Tank, ten infected, Rochelle, Coach, Ellis, a gnome, a cola and a med kit here.

React

>look
Stage
You can see a Tank, ten infected, Rochelle, Coach, Ellis, a gnome, a cola and a med kit here.

React

>attack infected
Attacking is an action, not a reaction.

React

* * *

>look
Stage
You can see a Tank, Rochelle, Coach, Ellis, a gnome, a cola and a med kit here.

Act

>look
Stage
You can see a Tank, two infected, Rochelle, Coach, Ellis, a gnome, a cola and a med kit here.

Act

>attack infected
You make a mad dash at the infected and prepare to swing your katana. 
You managed to deal the finishing blow to the dead infected!
The common infected dies

The tank throws the concrete at Ellis. 
 This Infected got hit by aoe.

Ellis is hit by the rock.

Ellis lunges at the Tank and prepares to swing his katana. 
Ellis lands a few hits on the Tank and it growls furiously! 

Act

>look
Stage
You can see a Tank, Rochelle, Coach, Ellis, a gnome, a cola and a med kit here.

Act

>attack
(the Tank)
You lunge at the Tank and prepare to swing your katana. 
You land a hit on the Tank, and it roars in anger!

Rochelle dashes at the Tank and prepares to swing her katana. 
Rochelle lands a few hits on the Tank and it roars furiously! 

Coach dashes at the Tank and prepares to swing his katana. 
Coach lands a few hits on the Tank and it snarls furiously! 

Ellis yells at the Tank and prepares to swing his katana. 
The Tank grabs a giant chunk of rock from the ground. 
Ellis lands a few hits on the Tank and it roars furiously! 

The tank throws the concrete at Rochelle. 
Rochelle is hit by the rock.

Act

>attack
(the Tank)
You run towards the Rochelle and prepare to swing your katana. 
You land a hit on the Tank, and it roars in anger!

some infecteds heard the noises and have entered the stage. 
Ellis: "I'm "a reload!"

some infecteds heard the noises and have entered the stage. 
Rochelle lunges at the infected and prepares to swing her katana. 
The infected gets ready for quick evasive maneuvers.

 This Infected got hit by aoe.

Rochelle lands the finishing blow on the dead infected!
The common infected dies

some infecteds heard the noises and have entered the stage. 
some infecteds heard the noises and have entered the stage. 
The infected lunges towards you.

React

>dodge
The infected misses you.

some infecteds heard the noises and have entered the stage. 
The infected lunges towards you.

React

>doge
That's not a verb I recognise.

React

>dodge
This Infected got hit by aoe.
 This Infected got hit by aoe.
 This Infected got hit by aoe.

The infected hits you.

some infecteds heard the noises and have entered the stage. 
Act

>attack infected
You lunge at the you and prepare to swing your katana. 
You managed to deal the finishing blow to the dead infected!
The common infected dies

some infecteds heard the noises and have entered the stage. 
Ellis: "RELOADING!"

some infecteds heard the noises and have entered the stage. 
The Tank grabs a giant chunk of rock from the ground. 
some infecteds heard the noises and have entered the stage. 
some infecteds heard the noises and have entered the stage. 
The infected lunges towards Coach.

 This Infected got hit by aoe.
 This Infected got hit by aoe.
 This Infected got hit by aoe.

The infected hits Coach.Coach groans trying to stand up.

some infecteds heard the noises and have entered the stage. 
Coach lunges at the infected and prepares to swing his katana. 
The infected gets ready for quick evasive maneuvers.

 This Infected got hit by aoe.
 This Infected got hit by aoe.

Coach lands the finishing blow on the dead infected!
The common infected dies

some infecteds heard the noises and have entered the stage. 
Act

>attack infected
You run towards the dead infected and prepare to swing your katana. 
You managed to deal the finishing blow to the dead infected!
The common infected dies

some infecteds heard the noises and have entered the stage. 
some infecteds heard the noises and have entered the stage. 
The infected lunges towards Rochelle.

The infected hits Rochelle.Rochelle groans trying to stand up.

some infecteds heard the noises and have entered the stage. 
The tank throws the concrete at Coach. 
Coach is hit by the rock.

some infecteds heard the noises and have entered the stage. 
some infecteds heard the noises and have entered the stage. 
The infected lunges towards Ellis.

The infected misses Ellis.

some infecteds heard the noises and have entered the stage. 
The infected lunges towards you.

React

>dodge
The infected misses you.

some infecteds heard the noises and have entered the stage. 
Coach dashes at the infected and prepares to swing his katana. 
The infected gets ready for quick evasive maneuvers.

 This Infected got hit by aoe.

Coach lands the finishing blow on the dead infected!
The common infected dies

some infecteds heard the noises and have entered the stage. 
Ellis rushes at the infected and prepares to swing his katana. 
The infected gets ready for quick evasive maneuvers.

 This Infected got hit by aoe.
 This Infected got hit by aoe.

Ellis lands the finishing blow on the dead infected!
The common infected dies

some infecteds heard the noises and have entered the stage. 
Act

>look
Stage
You can see six infected, a Tank, Rochelle, Coach, Ellis, a gnome, a cola and a med kit here.

Act

>attack infected
You lunge at the dead infected and prepare to swing your katana. 
You managed to deal the finishing blow to the dead infected!
The common infected dies

some infecteds heard the noises and have entered the stage. 
The infected lunges towards you.

React

>look
Stage
You can see six infected, a Tank, Rochelle, Coach, Ellis, a gnome, a cola and a med kit here.

React

>dodge
The infected hits you.

some infecteds heard the noises and have entered the stage. 
The Tank grabs a giant chunk of rock from the ground. 
some infecteds heard the noises and have entered the stage. 
Rochelle dashes at the Tank and prepares to swing her katana. 
 This Infected got hit by aoe.

Rochelle lands a few hits on the Tank and it snarls furiously! 

some infecteds heard the noises and have entered the stage. 
Coach readies Coach's katana.

some infecteds heard the noises and have entered the stage. 
The infected lunges towards Ellis.

 This Infected got hit by aoe.
 This Infected got hit by aoe.
 This Infected got hit by aoe.

The infected hits Ellis.

some infecteds heard the noises and have entered the stage. 
Ellis yells at the infected and prepares to swing his katana. 
The infected gets ready for quick evasive maneuvers.

 This Infected got hit by aoe.
 This Infected got hit by aoe.

Ellis lands the finishing blow on the dead infected!
The common infected dies

some infecteds heard the noises and have entered the stage. 
The infected lunges towards Coach.

The infected misses Coach.

some infecteds heard the noises and have entered the stage. 
Act

>attack
What do you want to attack?

Act

>attack infected
You make a mad dash at the Coach and prepare to swing your katana. 
 This Infected got hit by aoe.

You managed to deal the finishing blow to the dead infected!
The common infected dies

some infecteds heard the noises and have entered the stage. 
The infected lunges towards Ellis.

The infected misses Ellis.

some infecteds heard the noises and have entered the stage. 
Coach lunges at the infected and prepares to swing his katana. 
 This Infected got hit by aoe.
 This Infected got hit by aoe.

Coach lands the finishing blow on the dead infected!
The common infected dies

some infecteds heard the noises and have entered the stage. 
Rochelle readies Rochelle's katana.

some infecteds heard the noises and have entered the stage. 
The tank throws the concrete at Ellis. 
 This Infected got hit by aoe.
 This Infected got hit by aoe.

Ellis is hit by the rock.

some infecteds heard the noises and have entered the stage. 
The infected lunges towards you.

React

>look
Stage
You can see seven infected, a Tank, Rochelle, Coach, Ellis, a gnome, a cola and a med kit here.

React

>rules on
Rules tracing now switched on. Type "rules off" to switch it off again, or "rules all" to include even rules which do not apply.

[Rule "standard active attacking first phase rule" applies.]
Ellis lunges at the infected and prepares to swing his katana. 
[Rule "standard carry out dodging rule" applies.]
[Rule "do not report actor dodge rule" applies.]
[Rule "standard dodge prose rule" applies.]
The infected gets ready for quick evasive maneuvers.

[Rule "standard attacking second phase rule" applies.]
The infected hits you.

[Rule "standard attacking second phase rule" applies.]
 This Infected got hit by aoe.

Ellis lands the finishing blow on the dead infected!
The common infected dies

some infecteds heard the noises and have entered the stage. 
Act

* * *

>attack infecteds
[Rule "Does the player mean attacking a person" applies.]
[Rule "Does the player mean attacking a person" applies.]
[Rule "Does the player mean attacking a person" applies.]
[Rule "Does the player mean attacking a person" applies.]
[Rule "Does the player mean attacking a killed person" applies.]
[Rule "Does the player mean attacking a killed person" applies.]
[Rule "Does the player mean attacking a killed person" applies.]
[Rule "Does the player mean attacking a killed person" applies.]
[Rule "Does the player mean attacking a killed person" applies.]
[Rule "Does the player mean attacking a killed person" applies.]
[Rule "only attack persons rule" applies.]
[Rule "only attack the living rule" applies.]
[Rule "do not kill yourself rule" applies.]
[Rule "do not attack friendly people rule" applies.]
[Rule "do not attack neutral people rule" applies.]
[Rule "cannot attack as reaction rule" applies.]
[Rule "cannot attack when out of ammo rule" applies.]
[Rule "standard active attacking first phase rule" applies.]
You run towards the infected and prepare to swing your katana. 
[Rule "standard concentrating improves initiative rule" applies.]
[Rule "standard carry out concentrating rule" applies.]
[Rule "actor concentrating prose rule" applies.]
[Rule "only attack persons rule" applies.]
[Rule "only attack the living rule" applies.]
[Rule "do not kill yourself rule" applies.]
[Rule "do not attack friendly people rule" applies.]
[Rule "do not attack neutral people rule" applies.]
[Rule "cannot attack as reaction rule" applies.]
[Rule "cannot attack when out of ammo rule" applies.]
[Rule "standard attacking second phase rule" applies.]
 This Infected got hit by aoe.
 This Infected got hit by aoe.

You managed to deal the finishing blow to the dead infected!
The common infected dies

some infecteds heard the noises and have entered the stage. 
[Rule "standard active attacking first phase rule" applies.]
The infected lunges towards you.

React

>dodge
[Rule "cannot dodge when not reacting rule" applies.]
[Rule "standard carry out dodging rule" applies.]
[Rule "do not report actor dodge rule" applies.]
[Rule "standard attacking second phase rule" applies.]
The infected misses you.

some infecteds heard the noises and have entered the stage. 
[Rule "implicit taking when readying rule" applies.]
[Rule "carry out readying when enclosing rule" applies.]
[Rule "unready all other weapons rule" applies.]
[Rule "standard report readying rule" applies.]
Rochelle readies Rochelle's ak-47.

some infecteds heard the noises and have entered the stage. 
[Rule "standard active attacking first phase rule" applies.]
The infected lunges towards you.

React

>dodge
[Rule "cannot dodge when not reacting rule" applies.]
[Rule "standard carry out dodging rule" applies.]
[Rule "do not report actor dodge rule" applies.]
[Rule "standard attacking second phase rule" applies.]
The infected misses you.

[Rule "ready upon reloading rule" applies.]
[Rule "cannot ready what is already readied rule" applies.]
[Rule "implicit taking when readying rule" applies.]
[Rule "can't take yourself rule" applies.]
[Rule "can't take other people rule" applies.]
[Rule "can't take component parts rule" applies.]
[Rule "can't take items out of play rule" applies.]
[Rule "can't take what you're inside rule" applies.]
[Rule "can't take what's already taken rule" applies.]
[Rule "can't take scenery rule" applies.]
[Rule "can only take things rule" applies.]
[Rule "can't take what's fixed in place rule" applies.]
[Rule "use player's holdall to avoid exceeding carrying capacity rule" applies.]
[Rule "can't exceed carrying capacity rule" applies.]
[Rule "can't take living people's possessions rule" applies.]
That seems to belong to Coach.

[Rule "carry out readying when enclosing rule" applies.]
[Rule "unready all other weapons rule" applies.]
[Rule "zero current ammo on reloading rule" applies.]
[Rule "standard carry out reloading rule" applies.]
[Rule "Report Coach reloading" applies.]
"Coach: RELOADING!"

[Rule "standard active attacking first phase rule" applies.]
The infected lunges towards Rochelle.

[Rule "standard carry out dodging rule" applies.]
[Rule "do not report actor dodge rule" applies.]
[Rule "standard attacking second phase rule" applies.]
 This Infected got hit by aoe.
 This Infected got hit by aoe.
 This Infected got hit by aoe.

The infected hits Rochelle.

some infecteds heard the noises and have entered the stage. 
[Rule "standard concentrating improves initiative rule" applies.]
[Rule "standard carry out concentrating rule" applies.]
[Rule "actor concentrating prose rule" applies.]
some infecteds heard the noises and have entered the stage. 
[Rule "standard active attacking first phase rule" applies.]
The tank throws the concrete at Ellis. 
[Rule "standard carry out dodging rule" applies.]
[Rule "do not report actor dodge rule" applies.]
[Rule "standard attacking second phase rule" applies.]
 This Infected got hit by aoe.

Ellis is hit by the rock.

Ellis groans trying to stand up.

some infecteds heard the noises and have entered the stage. 
Act

>attack infecteds
[Rule "Does the player mean attacking a person" applies.]
[Rule "Does the player mean attacking a person" applies.]
[Rule "Does the player mean attacking a person" applies.]
[Rule "Does the player mean attacking a killed person" applies.]
[Rule "Does the player mean attacking a killed person" applies.]
[Rule "Does the player mean attacking a killed person" applies.]
[Rule "Does the player mean attacking a killed person" applies.]
[Rule "Does the player mean attacking a killed person" applies.]
[Rule "Does the player mean attacking a killed person" applies.]
[Rule "only attack persons rule" applies.]
[Rule "only attack the living rule" applies.]
[Rule "do not kill yourself rule" applies.]
[Rule "do not attack friendly people rule" applies.]
[Rule "do not attack neutral people rule" applies.]
[Rule "cannot attack as reaction rule" applies.]
[Rule "cannot attack when out of ammo rule" applies.]
[Rule "standard active attacking first phase rule" applies.]
You lunge at the Ellis and prepare to swing your katana. 
[Rule "standard concentrating improves initiative rule" applies.]
[Rule "standard carry out concentrating rule" applies.]
[Rule "actor concentrating prose rule" applies.]
[Rule "only attack persons rule" applies.]
[Rule "only attack the living rule" applies.]
[Rule "do not kill yourself rule" applies.]
[Rule "do not attack friendly people rule" applies.]
[Rule "do not attack neutral people rule" applies.]
[Rule "cannot attack as reaction rule" applies.]
[Rule "cannot attack when out of ammo rule" applies.]
[Rule "standard attacking second phase rule" applies.]
 This Infected got hit by aoe.

You managed to deal the finishing blow to the dead infected!
The common infected dies

some infecteds heard the noises and have entered the stage. 
[Rule "standard active attacking first phase rule" applies.]
The infected lunges towards you.

React

>dodge
[Rule "cannot dodge when not reacting rule" applies.]
[Rule "standard carry out dodging rule" applies.]
[Rule "do not report actor dodge rule" applies.]
[Rule "standard attacking second phase rule" applies.]
 This Infected got hit by aoe.

The infected hits you.

some infecteds heard the noises and have entered the stage. 
[Rule "ready upon reloading rule" applies.]
[Rule "zero current ammo on reloading rule" applies.]
[Rule "standard carry out reloading rule" applies.]
[Rule "Report Rochelle reloading" applies.]
Rochelle: "RELOADING!"

some infecteds heard the noises and have entered the stage. 
[Rule "standard active attacking first phase rule" applies.]
The infected lunges towards Rochelle.

[Rule "standard carry out dodging rule" applies.]
[Rule "do not report actor dodge rule" applies.]
[Rule "standard attacking second phase rule" applies.]
The infected misses Rochelle.

[Rule "standard active attacking first phase rule" applies.]
The infected lunges towards Rochelle.

[Rule "standard carry out dodging rule" applies.]
[Rule "do not report actor dodge rule" applies.]
[Rule "standard attacking second phase rule" applies.]
The infected misses Rochelle.

[Rule "standard active attacking first phase rule" applies.]
Coach yells at the infected and prepares to swing his katana. 
[Rule "standard concentrating improves initiative rule" applies.]
[Rule "standard carry out concentrating rule" applies.]
[Rule "actor concentrating prose rule" applies.]
[Rule "standard attacking second phase rule" applies.]
 This Infected got hit by aoe.
 This Infected got hit by aoe.

Coach lands the finishing blow on the dead infected!
The common infected dies

some infecteds heard the noises and have entered the stage. 
[Rule "standard concentrating improves initiative rule" applies.]
[Rule "standard carry out concentrating rule" applies.]
[Rule "actor concentrating prose rule" applies.]
some infecteds heard the noises and have entered the stage. 
[Rule "standard active attacking first phase rule" applies.]
The infected lunges towards Coach.

[Rule "parrying changes initiative rule" applies.]
[Rule "standard carry out parrying rule" applies.]
[Rule "do not report actor parry rule" applies.]
[Rule "standard attacking second phase rule" applies.]
The infected misses Coach.

[Rule "ready upon reloading rule" applies.]
[Rule "zero current ammo on reloading rule" applies.]
[Rule "standard carry out reloading rule" applies.]
[Rule "Report the Tank reloading" applies.]
The Tank grabs a giant chunk of rock from the ground. 
Act

>attack tank
[Rule "only attack persons rule" applies.]
[Rule "only attack the living rule" applies.]
[Rule "do not kill yourself rule" applies.]
[Rule "do not attack friendly people rule" applies.]
[Rule "do not attack neutral people rule" applies.]
[Rule "cannot attack as reaction rule" applies.]
[Rule "cannot attack when out of ammo rule" applies.]
[Rule "standard active attacking first phase rule" applies.]
You make a mad dash at the Coach and prepare to swing your katana. 
[Rule "parrying changes initiative rule" applies.]
[Rule "standard carry out parrying rule" applies.]
[Rule "do not report actor parry rule" applies.]
[Rule "only attack persons rule" applies.]
[Rule "only attack the living rule" applies.]
[Rule "do not kill yourself rule" applies.]
[Rule "do not attack friendly people rule" applies.]
[Rule "do not attack neutral people rule" applies.]
[Rule "cannot attack as reaction rule" applies.]
[Rule "cannot attack when out of ammo rule" applies.]
[Rule "standard attacking second phase rule" applies.]
 This Infected got hit by aoe.
 This Infected got hit by aoe.
 This Infected got hit by aoe.
 This Infected got hit by aoe.

You land a hit on the Tank, and it roars in anger!

some infecteds heard the noises and have entered the stage. 
[Rule "standard concentrating improves initiative rule" applies.]
[Rule "standard carry out concentrating rule" applies.]
[Rule "actor concentrating prose rule" applies.]
some infecteds heard the noises and have entered the stage. 
[Rule "standard active attacking first phase rule" applies.]
Coach lunges at the infected and prepares to swing his katana. 
[Rule "standard concentrating improves initiative rule" applies.]
[Rule "standard carry out concentrating rule" applies.]
[Rule "actor concentrating prose rule" applies.]
[Rule "standard attacking second phase rule" applies.]
 This Infected got hit by aoe.
 This Infected got hit by aoe.

Coach lands the finishing blow on the dead infected!
The common infected dies

some infecteds heard the noises and have entered the stage. 
[Rule "standard active attacking first phase rule" applies.]
Ellis lunges at the Tank and prepares to swing his katana. 
[Rule "standard carry out dodging rule" applies.]
[Rule "do not report actor dodge rule" applies.]
[Rule "standard attacking second phase rule" applies.]
 This Infected got hit by aoe.

Ellis lands a few hits on the Tank and it growls furiously! 

some infecteds heard the noises and have entered the stage. 
[Rule "standard active attacking first phase rule" applies.]
The tank throws the concrete at you. 
React

>dodge
[Rule "cannot dodge when not reacting rule" applies.]
[Rule "standard carry out dodging rule" applies.]
[Rule "do not report actor dodge rule" applies.]
[Rule "standard attacking second phase rule" applies.]
you got hit by the concrete.

some infecteds heard the noises and have entered the stage. 
[Rule "standard active attacking first phase rule" applies.]
The infected lunges towards Coach.

[Rule "ready upon reloading rule" applies.]
[Rule "cannot ready what is already readied rule" applies.]
[Rule "implicit taking when readying rule" applies.]
[Rule "can't take yourself rule" applies.]
[Rule "can't take other people rule" applies.]
[Rule "can't take component parts rule" applies.]
[Rule "can't take items out of play rule" applies.]
[Rule "can't take what you're inside rule" applies.]
[Rule "can't take what's already taken rule" applies.]
[Rule "can't take scenery rule" applies.]
[Rule "can only take things rule" applies.]
[Rule "can't take what's fixed in place rule" applies.]
[Rule "use player's holdall to avoid exceeding carrying capacity rule" applies.]
[Rule "can't exceed carrying capacity rule" applies.]
[Rule "can't take living people's possessions rule" applies.]
That seems to belong to Coach.

[Rule "carry out readying when enclosing rule" applies.]
[Rule "unready all other weapons rule" applies.]
[Rule "zero current ammo on reloading rule" applies.]
[Rule "standard carry out reloading rule" applies.]
[Rule "Report Coach reloading" applies.]
"Coach: Re-goddamn-loading!"

[Rule "standard attacking second phase rule" applies.]
The infected hits Coach.

some infecteds heard the noises and have entered the stage. 
[Rule "standard active attacking first phase rule" applies.]
The infected lunges towards Rochelle.

[Rule "standard carry out dodging rule" applies.]
[Rule "do not report actor dodge rule" applies.]
[Rule "standard attacking second phase rule" applies.]
The infected misses Rochelle.

some infecteds heard the noises and have entered the stage. 
[Rule "standard active attacking first phase rule" applies.]
Rochelle lunges at the infected and prepares to swing her katana. 
[Rule "standard carry out dodging rule" applies.]
[Rule "do not report actor dodge rule" applies.]
[Rule "standard dodge prose rule" applies.]
The infected gets ready for quick evasive maneuvers.

[Rule "standard attacking second phase rule" applies.]
 This Infected got hit by aoe.
 This Infected got hit by aoe.

Rochelle lands the finishing blow on the dead infected!
The common infected dies

some infecteds heard the noises and have entered the stage. 
Act

* * *

>rules off.
Rules tracing now switched off. Type "rules" to switch it on again.

The infected lunges towards Coach.

The infected misses Coach.

some infecteds heard the noises and have entered the stage. 
The infected lunges towards Ellis.

The infected misses Ellis.

Ellis rushes at the Tank and prepares to swing his katana. 
 This Infected got hit by aoe.
 This Infected got hit by aoe.

Ellis lands a few hits on the Tank and it snarls furiously! 

some infecteds heard the noises and have entered the stage. 
Coach yells at the infected and prepares to swing his katana. 
The infected gets ready for quick evasive maneuvers.

 This Infected got hit by aoe.
 This Infected got hit by aoe.

Coach lands the finishing blow on the dead infected!
The common infected dies

some infecteds heard the noises and have entered the stage. 
The tank throws the concrete at Coach. 
The Tank smashes Coach's body.
Coach has died.

some infecteds heard the noises and have entered the stage. 
The infected lunges towards Rochelle.

The infected misses Rochelle.

some infecteds heard the noises and have entered the stage. 
Rochelle lunges at the infected and prepares to swing her katana. 
The infected gets ready for quick evasive maneuvers.

 This Infected got hit by aoe.
 This Infected got hit by aoe.

Rochelle lands the finishing blow on the dead infected!
The common infected dies

some infecteds heard the noises and have entered the stage. 
Act

>look
Stage
You can see eight infected, a Tank, Rochelle, Coach's body, Ellis, a gnome, a cola and a med kit here.

Act

>attack infected
You lunge at the dead infected and prepare to swing your katana. 
You managed to deal the finishing blow to the dead infected!
The common infected dies

some infecteds heard the noises and have entered the stage. 
The infected lunges towards Rochelle.

 This Infected got hit by aoe.
 This Infected got hit by aoe.

The infected hits Rochelle.Rochelle groans trying to stand up.

some infecteds heard the noises and have entered the stage. 
Ellis readies Ellis' katana.

some infecteds heard the noises and have entered the stage. 
The Tank grabs a giant chunk of rock from the ground. 
some infecteds heard the noises and have entered the stage. 
The infected lunges towards Rochelle.

 This Infected got hit by aoe.

The infected hits Rochelle.

some infecteds heard the noises and have entered the stage. 
Act

>look
Stage
You can see nine infected, a Tank, Rochelle, Coach's body, Ellis, a gnome, a cola and a med kit here.

Act

>attack infected
You run towards the Rochelle and prepare to swing your katana. 
You managed to deal the finishing blow to the dead infected!
The common infected dies

some infecteds heard the noises and have entered the stage. 
The infected lunges towards Rochelle.

The infected misses Rochelle.

some infecteds heard the noises and have entered the stage. 
Ellis readies Ellis' ak-47.

Rochelle screams at the infected and prepares to swing her katana. 
The infected gets ready for quick evasive maneuvers.

Rochelle lands the finishing blow on the dead infected!
The common infected dies

some infecteds heard the noises and have entered the stage. 
The tank throws the concrete at Rochelle. 
 This Infected got hit by aoe.

The Tank smashes Rochelle's body.
Rochellle has died.

some infecteds heard the noises and have entered the stage. 
The infected lunges towards Ellis.

Ellis readies Ellis' katana.

 This Infected got hit by aoe.
 This Infected got hit by aoe.

The infected hits Ellis.

some infecteds heard the noises and have entered the stage. 
Act

>attack infected
You lunge at the Ellis and prepare to swing your katana. 
You managed to deal the finishing blow to the dead infected!
The common infected dies

some infecteds heard the noises and have entered the stage. 
The infected lunges towards Ellis.

 This Infected got hit by aoe.
 This Infected got hit by aoe.

The infected hits Ellis.

some infecteds heard the noises and have entered the stage. 
some infecteds heard the noises and have entered the stage. 
The Tank grabs a giant chunk of rock from the ground. 
some infecteds heard the noises and have entered the stage. 
The infected lunges towards you.

React

>attack infected
Attacking is an action, not a reaction.

React

>dodge
The infected misses you.

Act

>look
Stage
You can see ten infected, a Tank, Rochelle's body, Coach's body, Ellis, a gnome, a cola and a med kit here.

Act

>attack infected
You make a mad dash at the you and prepare to swing your katana. 
You managed to deal the finishing blow to the dead infected!
The common infected dies

some infecteds heard the noises and have entered the stage. 
Ellis readies Ellis' ak-47.

The infected lunges towards Ellis.

The infected misses Ellis.

The tank throws the concrete at Ellis. 
 This Infected got hit by aoe.
 This Infected got hit by aoe.

The Tank smashes Ellis's body.
Ellis has died.

some infecteds heard the noises and have entered the stage. 
The infected lunges towards you.

React

>look
Stage
You can see nine infected, a Tank, Rochelle's body, Coach's body, Ellis's body, a gnome, a cola and a med kit here.

React

>numbers on
You will now see combat-related numbers.

React

>attack
What do you want to attack?

React

>infected
Attacking is an action, not a reaction.

React

>dodge
Rolling 7 + 1 (inherent bonus) + 2 (concentration) - 2 (defender dodging) = 8, the infected beats your defence rating of 7.

The infected deals 2 This Infected got hit by aoe.

 = 2 damage, wounding you to 15 health.

The infected hits you.

some infecteds heard the noises and have entered the stage. 
Act

>look
Stage
You can see nine infected, a Tank, Rochelle's body, Coach's body, Ellis's body, a gnome, a cola and a med kit here.

Act

>heal
That's not a verb I recognise.

Act

* * *

>look
Stage
You can see a Tank, Rochelle, Coach, Ellis, a gnome, a cola and a med kit here.

Act

>attack tank
You lunge at the Coach and prepare to swing your katanafire. 
You land a hit on the Tank, and it roars in anger!

Coach lunges at the Tank and prepares to swing his katana. 
Coach lands a few hits on the Tank and it roars furiously! 

Ellis readies Ellis' ak-47.

Rochelle dashes at the Tank and prepares to swing her katana. 
Rochelle lands a few hits on the Tank and it snarls furiously! 

Act

>i
You are carrying:
  ak-47 (6 of 6 shots left)
  katana (readied)

Act

>ready ak
(ak-47)
You ready ak-47.

The tank throws the concrete at Coach. 
Coach is hit by the rock.

Ellis yells at the Tank and prepares to fire. 
Ellis lands a few hits on the Tank and it growls furiously! 

Rochelle screams at the Tank and prepares to fire. 
Rochelle lands a few hits on the Tank ! 

Act

>shoot tank
You make a mad dash at the Tank and prepare to fire. 
You land a hit on the Tank, and it roars in anger!

Coach yells at the Tank and prepares to fire. 
The Tank grabs a giant chunk of rock from the ground. 
Coach lands a few hits on the Tank ! 

some infecteds heard the noises and have entered the stage. 
some infecteds heard the noises and have entered the stage. 
The infected lunges towards Rochelle.

The infected misses Rochelle.

some infecteds heard the noises and have entered the stage. 
Ellis lunges at the Tank and prepares to fire. 
 This Infected got hit by aoe.
 This Infected got hit by aoe.

Ellis lands a few hits on the Tank and it snarls furiously! 

some infecteds heard the noises and have entered the stage. 
Act

>look
Stage
You can see two infected, a Tank, Rochelle, Coach, Ellis, a gnome, a cola and a med kit here.

Act

>attack atank
You can't see any such thing.

Act

>attack tank
You lunge at the Tank and prepare to fire. 
You land a hit on the Tank, and it roars in anger!

some infecteds heard the noises and have entered the stage. 
The tank throws the concrete at Rochelle. 
 This Infected got hit by aoe.
 This Infected got hit by aoe.

Rochelle is hit by the rock.

Rochelle groans trying to stand up.

some infecteds heard the noises and have entered the stage. 
Coach lunges at the Tank and prepares to fire. 
Coach lands a few hits on the Tank and it roars furiously! 

some infecteds heard the noises and have entered the stage. 
The infected lunges towards Coach.

The infected misses Coach.

some infecteds heard the noises and have entered the stage. 
some infecteds heard the noises and have entered the stage. 
The infected lunges towards Rochelle.

The infected misses Rochelle.

some infecteds heard the noises and have entered the stage. 
The infected lunges towards you.

React

>dodge
This Infected got hit by aoe.
 This Infected got hit by aoe.
 This Infected got hit by aoe.
 This Infected got hit by aoe.

The infected hits you.

some infecteds heard the noises and have entered the stage. 
some infecteds heard the noises and have entered the stage. 
The Tank grabs a giant chunk of rock from the ground. 
some infecteds heard the noises and have entered the stage. 
The infected lunges towards Coach.

The infected misses Coach.

some infecteds heard the noises and have entered the stage. 
Act

>look
Stage
You can see six infected, a Tank, Rochelle, Coach, Ellis, a gnome, a cola and a med kit here.

Act

>attack infected
You make a mad dash at the Coach and prepare to fire. 
The infected gets ready for quick evasive maneuvers.

 This Infected got hit by aoe.

You managed to deal the finishing blow to an dead infected!

You kill the infected.

some infecteds heard the noises and have entered the stage. 
The infected lunges towards Ellis.

The infected misses Ellis.

some infecteds heard the noises and have entered the stage. 
Coach yells at the infected and prepares to fire. 
The infected gets ready for quick evasive maneuvers.

 This Infected got hit by aoe.
 This Infected got hit by aoe.
 This Infected got hit by aoe.

Coach lands the finishing blow on an dead infected!

Coach kills the infected.

some infecteds heard the noises and have entered the stage. 
Rochelle lunges at the Tank and prepares to fire. 
 This Infected got hit by aoe.
 This Infected got hit by aoe.

Rochelle lands a few hits on the Tank and it snarls furiously! 

some infecteds heard the noises and have entered the stage. 
The infected lunges towards Ellis.

The infected misses Ellis.

some infecteds heard the noises and have entered the stage. 
Ellis rushes at the Tank and prepares to fire. 
 This Infected got hit by aoe.
 This Infected got hit by aoe.
 This Infected got hit by aoe.
 This Infected got hit by aoe.

Ellis lands a few hits on the Tank and it roars furiously! 

some infecteds heard the noises and have entered the stage. 
The tank throws the concrete at Rochelle. 
 This Infected got hit by aoe.

Rochelle is hit by the rock.

some infecteds heard the noises and have entered the stage. 
Act

>look
Stage
You can see an infected, a Tank, Rochelle, Coach, Ellis, a gnome, a cola and a med kit here.

Act

* * *

>attack infected
You make a mad dash at the Ellis and prepare to swing your katanafire. 
 This Infected got hit by aoe.

You managed to deal the finishing blow to an dead infected!

You kill the infected.

Coach yells at the Tank and prepares to swing his katana. 
 This Infected got hit by aoe.

Coach lands a few hits on the Tank and it growls furiously! 

Rochelle lunges at the Tank and prepares to swing her katana. 
Rochelle lands a few hits on the Tank and it snarls furiously! 

The Tank grabs a giant chunk of rock from the ground. 
Act

>i
You are carrying:
  ak-47 (readied) (3 of 6 shots left)
  katana

React

>attack tank
Attacking is an action, not a reaction.

React

>attack tank
Attacking is an action, not a reaction.

React

>dodge
The infected misses you.

The infected lunges towards Rochelle.

The infected misses Rochelle.

The infected lunges towards Ellis.

The infected misses Ellis.

Coach lunges at the infected and prepares to swing his katana. 
The infected gets ready for quick evasive maneuvers.

 This Infected got hit by aoe.
 This Infected got hit by aoe.
 This Infected got hit by aoe.
 This Infected got hit by aoe.
 This Infected got hit by aoe.
 This Infected got hit by aoe.
 This Infected got hit by aoe.

Coach lands the finishing blow on the dead infected!
The common infected dies

Rochelle readies Rochelle's ak-47.

The infected lunges towards Ellis.

The infected misses Ellis.

The infected lunges towards Coach.

 This Infected got hit by aoe.
 This Infected got hit by aoe.

The infected hits Coach.Coach groans trying to stand up.

The Tank readies the Rock.

Act

>attack
What do you want to attack?

Act

>look
Stage
You can see a Tank, an infected, Rochelle, Coach, Ellis, a gnome, a cola and a med kit here.

Act

>attack infected
You run towards the Rochelle and prepare to fire. 
The infected gets ready for quick evasive maneuvers.

 This Infected got hit by aoe.

You managed to deal the finishing blow to the dead infected!
The common infected dies

Coach dashes at the Tank and prepares to fire. 
Coach lands a few hits on the Tank and it growls furiously! 

Rochelle lunges at the Tank and prepares to fire. 
Rochelle lands a few hits on the Tank ! 

Ellis lunges at the Tank and prepares to fire. 
The Tank grabs a giant chunk of rock from the ground. 
Ellis lands a few hits on the Tank and it roars furiously! 

Act

>attack infected
You can't see any such thing.

Act

>look
Stage
You can see a Tank, Rochelle, Coach, Ellis, a gnome, a cola and a med kit here.

Act

>attack infected
You can't see any such thing.

Act

* * *

>look
Stage
You can see a Tank, Rochelle, Coach, Ellis, a gnome, a cola and a med kit here.

Act

>look infected
You can't see any such thing.

Act

>look
Stage
You can see a Tank, Rochelle, Coach, Ellis, a gnome, a cola and a med kit here.

Act

>attack tank
You lunge at the Tank and prepare to fire. 
You land a hit on the Tank, and it roars in anger!

The tank throws the concrete at you. 
React

>dodge
you got hit by the concrete.

Rochelle dashes at the Tank and prepares to fire. 
Rochelle lands a few hits on the Tank and it snarls furiously! 

Ellis yells at the Tank and prepares to fire. 
The Tank grabs a giant chunk of rock from the ground. 
Ellis lands a few hits on the Tank ! 

Act

>dodge
You dodge, but there is no attack.

Act

>attack tank
You make a mad dash at the Tank and prepare to fire. 
You land a hit on the Tank, and it roars in anger!

Coach yells at the Tank and prepares to fire. 
Coach lands a few hits on the Tank ! 

some infecteds heard the noises and have entered the stage. 
The infected lunges towards you.

React

>dodge
The infected misses you.

some infecteds heard the noises and have entered the stage. 
The tank throws the concrete at Coach. 
Coach is hit by the rock.

some infecteds heard the noises and have entered the stage. 
The infected lunges towards Rochelle.

The infected misses Rochelle.

some infecteds heard the noises and have entered the stage. 
Ellis lunges at the infected and prepares to fire. 
The infected gets ready for quick evasive maneuvers.

 This Infected got hit by aoe.
 This Infected got hit by aoe.
 This Infected got hit by aoe.

Ellis lands the finishing blow on the dead infected!
The common infected dies

some infecteds heard the noises and have entered the stage. 
Act